1111111111
1E01000001
110C011101
1111111101
111110C001
1111101111
100C100001
1010111001
1P10000001
1111111111
